# usar Playground para los test los respuestas de la AI:
# https://platform.openai.com/playground?model=text-davinci-003

#app python cloud
#https://www.pythonanywhere.com/

#API: una amplia base de datos gratis de questionarios para diferentes temas sera usada (para modo no fiesta)
#https://opentdb.com/api_config.php



# posible formato de entrada:
#--------------------modo fiesta----------------------------------

usando un lenguaje vulgar genera 2 pregunta en (español) , contexto de la pregunta es “ligar chicas” y la siguiente pregunta 2 se basa en el contexto de la ultima respuesta correcta de la pregunta anterior y así sucesivamente.

El formato es:
{Pregunta:
Opciones:
A)
B)
C)
D)
Respuesta correcta: }

#--------------------modo general----------------------------------
# Créame 4 pregunta en (español) , contexto de la pregunta es “marvel” y la siguiente pregunta 2 se basa en el contexto de la ultima respuesta correcta de la pregunta anterior y asi sucesivamente.
# El formato es:
# {Pregunta:
#opciones:
# A)
# B)
# C)
# D)
# Respuesta correcta: }












Afrikaans: 'af'
Albanian: 'sq'
Amharic: 'am'
Arabic: 'ar'
Armenian: 'hy'
Azerbaijani: 'az'
Basque: 'eu'
Belarusian: 'be'
Bengali: 'bn'
Bosnian: 'bs'
Bulgarian: 'bg'
Catalan: 'ca'
Cebuano: 'ceb' (para el idioma cebuano)
Chichewa: 'ny' (para el idioma chewa)
Chinese (simplified): 'zh-cn'
Chinese (traditional): 'zh-tw'
Corsican: 'co'
Croatian: 'hr'
Czech: 'cs'
Danish: 'da'
Dutch: 'nl'
English: 'en'
Esperanto: 'eo'
Estonian: 'et'
Filipino: 'tl' (para el idioma tagalo)
Finnish: 'fi'
French: 'fr'
Frisian: 'fy'
Galician: 'gl'
Georgian: 'ka'
German: 'de'
Greek: 'el'
Gujarati: 'gu'
Haitian Creole: 'ht'
Hausa: 'ha'
Hawaiian: 'haw'
Hebrew: 'he' o 'iw'
Hindi: 'hi'
Hmong: 'hmn'
Hungarian: 'hu'
Icelandic: 'is'
Igbo: 'ig'
Indonesian: 'id' o 'in'
Irish: 'ga'
Italian: 'it'
Japanese: 'ja'
Javanese: 'jw'
Kannada: 'kn'
Kazakh: 'kk'
Khmer: 'km'
Kinyarwanda: 'rw'
Korean: 'ko'
Kurdish: 'ku'
Kyrgyz: 'ky'
Lao: 'lo'
Latin: 'la'
Latvian: 'lv'
Lithuanian: 'lt'
Luxembourgish: 'lb'
Macedonian: 'mk'
Malagasy: 'mg'
Malay: 'ms'
Malayalam: 'ml'
Maltese: 'mt'
Maori: 'mi'
Marathi: 'mr'
Mongolian: 'mn'
Myanmar (Burmese): 'my'
Nepali: 'ne'
Norwegian: 'no'
Nyanja: 'ny' (para el idioma chichewa)
Pashto: 'ps'
Persian: 'fa'
Polish: 'pl'
Portuguese: 'pt'
Punjabi: 'pa'
Romanian: 'ro'
Russian: 'ru'
Samoan: 'sm'
Scots Gaelic: 'gd'
Serbian: 'sr'
Sesotho: 'st'
Shona: 'sn'
Sindhi: 'sd'
Sinhala: 'si'
Slovak: 'sk'
Slovenian: 'sl'
Somali: 'so'
Spanish: 'es'
Sundanese: 'su'
Swahili: 'sw'
Swedish: 'sv'
Tajik: 'tg'
Tamil: 'ta'
Telugu: 'te'
Thai: 'th'
Turkish: 'tr'
Ukrainian: 'uk'
Urdu: 'ur'



